1111111111111111111111111
1P00000100000000000000001
1111110101111111111111101
1C00000101000000000000101
1011111101011111111110101
100000000101C000000010101
1111111111011111111010101
100C000E00000X00001010101
1011111111111111111000001
1111111111111111111111111
