111111
1P0001
111111
1CX0E1
111111