111111
1P0001
111111
1C00E1
111111