111111
1P0001
111101
1CX0E1
111111