1111111111111111111111111111111111111111
1PC00CCC0C00C000CC0CXC00C00E00C010001001
100CC0010C00X000000010000100000000CC1001
1100C00X0000100101001110001000C000000001
10000100100101100011000000C00001010C1C01
10C10000C10C00C01C10011C000C10CC00110111
101C01000X000X000C110010000101C100000001
1000000000000C1001000000000100C0C11C0001
1010000001C01100C00000C000001000101000C1
11010X0000101000110C01C00C00000100000101
110000010010000001011000000110000C000001
10000010000010000X0000001000C1XCC00CC011
10000C0C000100CC011000100000000000C00101
1100X0000X0000000C0110001C0010010000C001
101010000011C010000000100001100000010001
10101000CCCC0100C01001000000010C1000C0C1
110C0C000000111011000000010101C00C000101
10000000C000X00000C100000100000C00101011
10C000000001000C011101100000C0C000100101
1111111111111111111111111111111111111111
