11111111111111111111
1P010000000001000001
1100001000C000100X01
1100101001C00100C001
100C010110100CC00011
1C0E0X0C0000000X0001
1001000C0001000101C1
10010000C00010000101
100000C0000101001011
11111111111111111111
