111111111111111111111111111111111111111111111111111111111111
1P00CC00000C0011000C00C0000C000000000100000000000C0000000111
11C0100C00C000000C0000010000000001100000C0110100001000100111
1000000010100010000111001C00110100001000000CC0C000000110CC11
100000000000000C00001100001000C001C000C000010000100000000C11
11C000C0010C00000110001110000110C0000000101000C001001000C011
1C1000C000000C00C010010100000100C0100C000C0100C1C00C01011001
10C01C10000100C001000000100000C110C1110100C10000111000000001
11000C0000C0C0011C11C010001011000C001C00000C0C0001110C1C0001
100C001C0C00C110000C00001C0C001000000000C000C00011C010010011
100000000100000C0000101001000100001010000100000000000C000001
101000000010000C0000000100001C011000101100110001000000100101
1C10000000100C0C000000C001010000001110000001C101C100000C0001
10000000000000111C00000000000000001000010C0000000000000C00C1
10C0000001CC000000C11000000100101C11C00000001CC0000C0CC00001
10010001C111010C00C00000000001C000010C0000C1010C000000C01001
10CC01100000C0C010CC0110C00C0001C01C0000111C110011010CCC0011
11C000000000C1000000CCC00100000001001000001C00000C01C0000011
11001000010000010101C0C0000000000010010C100000C0000000101011
1000000C11100000C100000010100101001000C0100000C00000C0000C01
110000000000100C100000C00110000100100C101000CC10000000100101
100100000C000100011000C00000011100000000001C0000000000C01C11
11111001000C100100C0000C000C0000C0C111101C010C000001C0CC0001
110000000000000000110C0C0CC0000000C001CC000010001C1000101011
100100010CC10C0010000C0010010C10100000000CCC110000001C00C101
10C000000000010000100C00C000000C1111C00010CC0000CC0CC0C000C1
11110010C00CC000C1100001000010100000000C00000001000C000C0001
1001100001000101000010C01C0001000C0010010C0000000001C0000CC1
10000100000000100000000001000CC0CCC00CCCC00C0000CCC0CE000011
111111111111111111111111111111111111111111111111111111111111
