111111111111111111111111111111111111111111111111111111111111
1P000000010000010011C0C11001000001000000010C0X001100C000C001
11CX000000000101000C100110011000010C0011000000CC011100001011
10C00000C000100C000C000001000C0000000C0001000100100011000001
100000000C00000001110100000001010001C0000000C000010000000001
1000010010001000C00000010000000000C00100CC0100X001000CC00001
11C01C0010C1000C0CC00000CC11000010010C00C01000100C0100001001
1000100C101000100000000000C00C11000C001100C10000C00000CC1001
10E100000000000000C001X000000CC00001C01000X00000C000XC00CCC1
1100000010CC010000111C01000000100001000CCC000C001C0100000101
110110000001000011C0000000101C0000C11000C0X001010000C0110001
100000001001110C10C0C00000C00110000000100000001CC00CCC0C0C01
1C0001100C0011C00000C100100000000000000001010000000101000011
1C00000000000000C0X01110000001C1000010C000110001010000000001
100000000C000110XC010C10100100X1000CC00001CCCC100C0101000001
10000010000100100000000001000C01C10010001C00000001C110000011
10010010110C000100000000000100000X01C110000001X1000000C10101
100001C00100001100C0010000010C1C000000101000000011C000000001
10000C0C00000011000000C000110C00010011010000000010001C000001
101C1000000C1C0000C000010000C10010000C00C1100110000110100101
1C00001C000110C0CC0C00000C01C110000000C100010000C00000100101
1CCC00001C1010000C01C00X001C0000010C10X1C0010000C000C0000011
10011011100000C0000011010C000000C000X00C0000110C0100000C0C11
11000C10C0C001010110X000100010100C01000X00C1000C001CC0001C11
100000001C00100010000110010000001C000001000000000000010000C1
10001000000001010C000011001C0000001000000000011001C000000011
1C0C01C00000000001000001001C000011001000000000C00C1000100011
101011000000C0000100000000010101001011001C01C00000C01C10C001
111011100100100000011000010C00C100010000C00110000000C000C001
111111111111111111111111111111111111111111111111111111111111
